1111111111111
1001000000001
1000010011111
1C0011EP00C11
1111111111111